"a" = (/turf,/area)
"b" = (/turf/wall,/area)
"c" = (/turf/floor,/area)
"d" = (/turf/window,/area)
"e" = (/turf/wall/secret_wall,/area)
"f" = (/mob,/turf/floor,/area)

(1,1,1) = {"
cbaaaaaaaa
cbbbdddbbb
ccfcdcccbb
cccceccccb
cccbbbbbbb
cccccbcccc
cccccccccc
ccccbbbbbb
cccccccccc
aaaaaaaaaa
"}
