"a" = (/turf/floor,/area/space)
"b" = (/turf/wall,/area/space)
"c" = (/turf,/area/space)
"d" = (/turf/window,/area/space)
"e" = (/obj/torch,/turf/floor,/area/space)
"f" = (/mob,/turf/floor,/area/space)
"g" = (/turf/wall/secret_wall,/area/space)

(1,1,1) = {"
abcccccccc
abbbdddbbb
aefadaaabb
aaaagaaaab
aaabbbbbbb
aaaeabaaaa
aaaaaaaaaa
aaaabbbbbb
aaaaaaaaaa
cccccccccc
"}
